444444444444
444444444444
440000004444
440144404444
440022404444
440414004444
440444044444
440000044444
444444444444
444444444444