444444444444
444444444444
440000004444
440142100444
440440440444
440442440444
440020240444
440144410444
440000000444
444444444444