444444444444
444440000444
444000440444
444042440444
444011240444
444044400444
444000004444
444444444444
444444444444
444444444444