444444444444
444000000444
444044410444
444044240444
444042010444
444044440444
444000000444
444444444444
444444444444
444444444444