444444444444
444444444444
444000000044
444044441044
444042201044
444004421044
444400444044
444440000044
444444444444
444444444444