444444444444
444000004444
444014400444
444042240444
444042140444
444000010444
444444000444
444444444444
444444444444
444444444444