444444444444
444444444444
444000000444
444044440004
444044411404
444042221404
444044044404
444000000004
444444444444
444444444444