444444444444
444444444444
440000044444
440144044444
440442004444
440424104444
440044404444
444000004444
444444444444
444444444444