444444444444
444444444444
444000000444
444044440444
444042240444
444044440444
444041140444
444000000444
444444444444
444444444444