444444444444
444444444444
444000004444
444044400044
444041414044
444002244044
444404400044
444404404444
444400004444
444444444444