444444444444
444440000444
444000440444
440041110444
440440440444
440422240444
440044440444
444000000444
444444444444
444444444444