444444444444
444000000004
444044044404
444042112404
444042134004
444042112404
444044044404
444000000004
444444444444
444444444444