444400004444
444004400044
444044244044
444043234044
444044344044
444001410044
444404400444
444400004444
444444444444
444444444444