444444444444
444444444444
444000004444
444044400444
444044440444
444002240444
444014100444
444000004444
444444444444
444444444444