444444444444
444444444444
440000444444
440440444444
440220000444
440424440444
440144410444
440444010444
440000000444
444444444444