444444444444
444444444444
444000000444
444044440444
440024110444
440440410444
440442200444
440444404444
440000004444
444444444444