444444444444
444444444444
444000000444
440044440044
440424224044
440111111044
440422424044
440004400044
444400004444
444444444444