444444444444
444444444444
440000004444
440442104444
440420404444
440414404444
440442104444
440000004444
444444444444
444444444444