444444444444
444440000444
440000440444
440440440444
440442240444
440444420444
440144040444
440100010444
440004000444
444444444444