444444444444
444444444444
444000044444
444044000444
444044240444
444012440444
444012140444
444000000444
444444444444
444444444444